25 23
0 1
WSPPPPPPPPPPPPPPPPPPWWW
PPWWWWWPWWWPWWPWWWWPWPP
PWWPPPWPWPPPPWPWWPWPWPW
PPPPWPWPWWPWPWPWWPWPWPW
PWWWWPWPPPWWPWPPPPWPWPW
PPPPWPWWWPPPPWWWWPWWWPW
PWWPPPWWWPWWWPPPWPPPPPW
PWPPWPWPWPWWWPWWWPWWWPW
PWPWWWWPPPPPPPPPPPWPWPW
PWPWWWWPWWWWWWPWWPWPWWW
PWWWPPPPWPWPWWPWWPWPPPP
PPPPPWPWPPWPPPPPWPWWPWP
WWWWWWPWPWPPWWWPWWWPPWP
PWWPPWPWPWPWWPPPPPPPWWP
PPWPPPPPPPPWPPWWPWPWPPP
PWWPWWWWWWPWPWWWPWPWWPW
PWPPWPWWPWPWPWPWPWPWWPW
PWPWWPPPPWPWPWPWPWPWWPP
PWPWPPWWPPPWPWPPPWPWWWP
PWPWPWWPPWWWPWPWWPPWPPP
WWPWPWPPWWWWPPPWPWPWPWP
PPPWPPWPPPPWPWPWPPPWPWP
WPWWWPWPWWPWPPPWWPWWPWP
PPPPWPWPPWPPWPPPWPWPPWP
PWWPPPPWPPWPPPWPPPWEWWP

